"filename", "language", "C", "Markdown", "comment", "blank", "total"
"d:\C_code\进阶day01\demo12.c", "C", 31, 0, 14, 5, 50
"d:\C_code\进阶day01\demo13.c", "C", 17, 0, 8, 3, 28
"d:\C_code\进阶day01\demo14.c", "C", 32, 0, 9, 4, 45
"d:\C_code\进阶day02\demo01.c", "C", 27, 0, 6, 6, 39
"d:\C_code\进阶day02\demo02.c", "C", 15, 0, 8, 3, 26
"d:\C_code\进阶day02\demo03.c", "C", 13, 0, 2, 3, 18
"d:\C_code\进阶day02\demo04.c", "C", 66, 0, 12, 9, 87
"d:\C_code\进阶day02\demo05.c", "C", 31, 0, 11, 5, 47
"d:\C_code\进阶day02\demo06.c", "C", 46, 0, 8, 9, 63
"d:\C_code\进阶day02\demo07.c", "C", 65, 0, 8, 9, 82
"d:\C_code\进阶day02\demo08.c", "C", 32, 0, 8, 6, 46
"d:\C_code\进阶day02\笔记.md", "Markdown", 0, 130, 0, 31, 161
"Total", "-", 375, 130, 94, 93, 692