"filename", "language", "C", "Markdown", "comment", "blank", "total"
"d:\C_code\REMADE.md", "Markdown", 0, 1, 0, 0, 1
"d:\C_code\day01\demo01.c", "C", 12, 0, 0, 2, 14
"d:\C_code\day01\demo02.c", "C", 17, 0, 1, 4, 22
"d:\C_code\day01\笔记.md", "Markdown", 0, 60, 0, 14, 74
"d:\C_code\day02\demo01.c", "C", 8, 0, 2, 4, 14
"d:\C_code\day02\demo02.c", "C", 8, 0, 1, 2, 11
"d:\C_code\day02\demo03.c", "C", 18, 0, 6, 3, 27
"d:\C_code\day02\demo04..c", "C", 16, 0, 6, 3, 25
"d:\C_code\day02\demo05.c", "C", 23, 0, 6, 2, 31
"d:\C_code\day02\demo06.c", "C", 12, 0, 4, 3, 19
"d:\C_code\day02\demo07.c", "C", 15, 0, 1, 2, 18
"d:\C_code\day02\demo08.c", "C", 14, 0, 3, 2, 19
"d:\C_code\day02\demo09.c", "C", 12, 0, 1, 2, 15
"d:\C_code\day02\demo10.c", "C", 19, 0, 3, 2, 24
"d:\C_code\day02\笔记.md", "Markdown", 0, 91, 0, 13, 104
"d:\C_code\day03\demo01.c", "C", 14, 0, 26, 5, 45
"d:\C_code\day03\demo02.c", "C", 16, 0, 4, 1, 21
"d:\C_code\day03\demo03.c", "C", 12, 0, 2, 2, 16
"d:\C_code\day03\demo04.c", "C", 17, 0, 1, 4, 22
"d:\C_code\day03\笔记.md", "Markdown", 0, 57, 0, 5, 62
"d:\C_code\day04\demo01.c", "C", 13, 0, 2, 3, 18
"d:\C_code\day04\demo02.c", "C", 8, 0, 5, 2, 15
"d:\C_code\day04\demo03.c", "C", 22, 0, 6, 3, 31
"d:\C_code\day04\demo04.c", "C", 14, 0, 4, 3, 21
"d:\C_code\day04\demo05.c", "C", 10, 0, 2, 3, 15
"d:\C_code\day04\demo06.c", "C", 12, 0, 2, 3, 17
"d:\C_code\day04\demo07.c", "C", 24, 0, 4, 3, 31
"d:\C_code\day04\笔记.md", "Markdown", 0, 66, 0, 18, 84
"d:\C_code\day05\demo01.c", "C", 24, 0, 4, 4, 32
"d:\C_code\day05\demo02.c", "C", 17, 0, 2, 3, 22
"d:\C_code\day05\笔记.md", "Markdown", 0, 57, 0, 10, 67
"d:\C_code\day06\demo01.c", "C", 7, 0, 1, 1, 9
"d:\C_code\day06\demo02.c", "C", 15, 0, 2, 3, 20
"d:\C_code\day06\demo03.c", "C", 37, 0, 6, 1, 44
"d:\C_code\day06\demo04.c", "C", 29, 0, 6, 4, 39
"d:\C_code\day06\笔记.md", "Markdown", 0, 13, 0, 0, 13
"d:\C_code\day07\demo01.c", "C", 16, 0, 1, 2, 19
"d:\C_code\day07\demo02.c", "C", 14, 0, 2, 3, 19
"d:\C_code\day07\demo03.c", "C", 21, 0, 7, 4, 32
"d:\C_code\day07\笔记.md", "Markdown", 0, 69, 0, 25, 94
"d:\C_code\day08\demo01.c", "C", 13, 0, 9, 2, 24
"d:\C_code\day08\demo02.c", "C", 31, 0, 9, 4, 44
"d:\C_code\day08\demo03.c", "C", 101, 0, 36, 11, 148
"d:\C_code\day08\demo04.c", "C", 9, 0, 7, 2, 18
"d:\C_code\day08\demo05.c", "C", 7, 0, 7, 2, 16
"d:\C_code\day08\笔记.md", "Markdown", 0, 33, 0, 4, 37
"d:\C_code\day09\demo01.c", "C", 50, 0, 14, 7, 71
"d:\C_code\day09\demo02.c", "C", 39, 0, 14, 4, 57
"d:\C_code\day09\笔记.md", "Markdown", 0, 6, 0, 1, 7
"d:\C_code\demo\add.c", "C", 5, 0, 0, 0, 5
"d:\C_code\demo\demo03.c", "C", 16, 0, 1, 2, 19
"d:\C_code\demo\lib\add.h", "C", 4, 0, 0, 3, 7
"d:\C_code\demo\lib\sub.h", "C", 4, 0, 0, 2, 6
"d:\C_code\demo\sub.c", "C", 5, 0, 0, 0, 5
"d:\C_code\demo\笔记.md", "Markdown", 0, 5, 0, 2, 7
"d:\C_code\进阶day01\demo01.c", "C", 14, 0, 7, 3, 24
"d:\C_code\进阶day01\demo02.c", "C", 25, 0, 6, 4, 35
"d:\C_code\进阶day01\demo03.c", "C", 18, 0, 7, 3, 28
"d:\C_code\进阶day01\demo04.c", "C", 28, 0, 8, 4, 40
"d:\C_code\进阶day01\demo05.c", "C", 28, 0, 8, 4, 40
"d:\C_code\进阶day01\demo06.c", "C", 15, 0, 11, 2, 28
"d:\C_code\进阶day01\demo07.c", "C", 19, 0, 10, 3, 32
"d:\C_code\进阶day01\demo08.c", "C", 19, 0, 6, 3, 28
"d:\C_code\进阶day01\demo09.c", "C", 12, 0, 1, 2, 15
"d:\C_code\进阶day01\demo10.c", "C", 16, 0, 6, 5, 27
"d:\C_code\进阶day01\demo11.c", "C", 24, 0, 5, 3, 32
"d:\C_code\进阶day01\demo12.c", "C", 31, 0, 14, 5, 50
"d:\C_code\进阶day01\demo13.c", "C", 17, 0, 8, 3, 28
"d:\C_code\进阶day01\demo14.c", "C", 32, 0, 9, 4, 45
"d:\C_code\进阶day01\作业笔记.md", "Markdown", 0, 5, 0, 3, 8
"d:\C_code\进阶day01\指针笔记.md", "Markdown", 0, 118, 0, 22, 140
"d:\C_code\进阶day01\数据存储笔记.md", "Markdown", 0, 136, 0, 23, 159
"d:\C_code\进阶day02\demo01.c", "C", 27, 0, 6, 6, 39
"d:\C_code\进阶day02\demo02.c", "C", 15, 0, 8, 3, 26
"d:\C_code\进阶day02\demo03.c", "C", 13, 0, 2, 3, 18
"d:\C_code\进阶day02\demo04.c", "C", 66, 0, 12, 9, 87
"d:\C_code\进阶day02\demo05.c", "C", 31, 0, 11, 5, 47
"d:\C_code\进阶day02\demo06.c", "C", 46, 0, 8, 9, 63
"d:\C_code\进阶day02\demo07.c", "C", 65, 0, 8, 9, 82
"d:\C_code\进阶day02\demo08.c", "C", 32, 0, 8, 6, 46
"d:\C_code\进阶day02\笔记.md", "Markdown", 0, 130, 0, 31, 161
"Total", "-", 1393, 847, 389, 396, 3025