"filename", "language", "Markdown", "C", "comment", "blank", "total"
"d:\C_code\REMADE.md", "Markdown", 1, 0, 0, 0, 1
"d:\C_code\day01\demo01.c", "C", 0, 12, 0, 2, 14
"d:\C_code\day01\demo02.c", "C", 0, 17, 1, 4, 22
"d:\C_code\day01\笔记.md", "Markdown", 60, 0, 0, 14, 74
"d:\C_code\day02\demo01.c", "C", 0, 8, 2, 4, 14
"d:\C_code\day02\demo02.c", "C", 0, 8, 1, 2, 11
"d:\C_code\day02\demo03.c", "C", 0, 18, 6, 3, 27
"d:\C_code\day02\demo04..c", "C", 0, 16, 6, 3, 25
"d:\C_code\day02\demo05.c", "C", 0, 23, 6, 2, 31
"d:\C_code\day02\demo06.c", "C", 0, 12, 4, 3, 19
"d:\C_code\day02\demo07.c", "C", 0, 15, 1, 2, 18
"d:\C_code\day02\demo08.c", "C", 0, 14, 3, 2, 19
"d:\C_code\day02\demo09.c", "C", 0, 12, 1, 2, 15
"d:\C_code\day02\demo10.c", "C", 0, 19, 3, 2, 24
"d:\C_code\day02\笔记.md", "Markdown", 91, 0, 0, 13, 104
"d:\C_code\day03\demo01.c", "C", 0, 14, 26, 5, 45
"d:\C_code\day03\demo02.c", "C", 0, 16, 4, 1, 21
"d:\C_code\day03\demo03.c", "C", 0, 12, 2, 2, 16
"d:\C_code\day03\demo04.c", "C", 0, 17, 1, 4, 22
"d:\C_code\day03\笔记.md", "Markdown", 57, 0, 0, 5, 62
"d:\C_code\day04\demo01.c", "C", 0, 13, 2, 3, 18
"d:\C_code\day04\demo02.c", "C", 0, 8, 5, 2, 15
"d:\C_code\day04\demo03.c", "C", 0, 22, 6, 3, 31
"d:\C_code\day04\demo04.c", "C", 0, 14, 4, 3, 21
"d:\C_code\day04\demo05.c", "C", 0, 10, 2, 3, 15
"d:\C_code\day04\demo06.c", "C", 0, 12, 2, 3, 17
"d:\C_code\day04\demo07.c", "C", 0, 24, 4, 3, 31
"d:\C_code\day04\笔记.md", "Markdown", 66, 0, 0, 18, 84
"d:\C_code\day05\demo01.c", "C", 0, 24, 4, 4, 32
"d:\C_code\day05\demo02.c", "C", 0, 17, 2, 3, 22
"d:\C_code\day05\笔记.md", "Markdown", 57, 0, 0, 10, 67
"d:\C_code\day06\demo01.c", "C", 0, 7, 1, 1, 9
"d:\C_code\day06\demo02.c", "C", 0, 15, 2, 3, 20
"d:\C_code\day06\demo03.c", "C", 0, 37, 6, 1, 44
"d:\C_code\day06\demo04.c", "C", 0, 29, 6, 4, 39
"d:\C_code\day06\笔记.md", "Markdown", 13, 0, 0, 0, 13
"d:\C_code\day07\demo01.c", "C", 0, 16, 1, 2, 19
"d:\C_code\day07\demo02.c", "C", 0, 14, 2, 3, 19
"d:\C_code\day07\demo03.c", "C", 0, 21, 7, 4, 32
"d:\C_code\day07\笔记.md", "Markdown", 69, 0, 0, 25, 94
"d:\C_code\day08\demo01.c", "C", 0, 13, 9, 2, 24
"d:\C_code\day08\demo02.c", "C", 0, 31, 9, 4, 44
"d:\C_code\day08\demo03.c", "C", 0, 101, 36, 11, 148
"d:\C_code\day08\demo04.c", "C", 0, 9, 7, 2, 18
"d:\C_code\day08\demo05.c", "C", 0, 7, 7, 2, 16
"d:\C_code\day08\笔记.md", "Markdown", 33, 0, 0, 4, 37
"d:\C_code\day09\demo01.c", "C", 0, 50, 14, 7, 71
"d:\C_code\day09\demo02.c", "C", 0, 39, 14, 4, 57
"d:\C_code\day09\笔记.md", "Markdown", 6, 0, 0, 1, 7
"d:\C_code\demo\add.c", "C", 0, 5, 0, 0, 5
"d:\C_code\demo\demo03.c", "C", 0, 16, 1, 2, 19
"d:\C_code\demo\lib\add.h", "C", 0, 4, 0, 3, 7
"d:\C_code\demo\lib\sub.h", "C", 0, 4, 0, 2, 6
"d:\C_code\demo\sub.c", "C", 0, 5, 0, 0, 5
"d:\C_code\demo\笔记.md", "Markdown", 5, 0, 0, 2, 7
"d:\C_code\进阶day01\demo01.c", "C", 0, 12, 7, 2, 21
"d:\C_code\进阶day01\demo02.c", "C", 0, 25, 6, 4, 35
"d:\C_code\进阶day01\demo03.c", "C", 0, 18, 7, 3, 28
"d:\C_code\进阶day01\demo04.c", "C", 0, 28, 8, 4, 40
"d:\C_code\进阶day01\demo05.c", "C", 0, 28, 8, 4, 40
"d:\C_code\进阶day01\demo06.c", "C", 0, 15, 11, 2, 28
"d:\C_code\进阶day01\demo07.c", "C", 0, 19, 10, 3, 32
"d:\C_code\进阶day01\指针笔记.md", "Markdown", 118, 0, 0, 22, 140
"d:\C_code\进阶day01\数据存储笔记.md", "Markdown", 88, 0, 0, 14, 102
"Total", "-", 664, 945, 277, 277, 2163